ALARM	AH L AA R M
COMMANDS	K AH M AE N D Z
CONNECTED	K AH N EH K T IH D
DYLAN	D IH L AH N
EMAIL	IY M EY L
EVENTS	IH V EH N T S
EVENTS(2)	IY V EH N T S
GET	G EH T
GET(2)	G IH T
IS	IH Z
LIGHT	L AY T
LIST	L IH S T
MATTHEW	M AE TH Y UW
ME	M IY
MUSIC	M Y UW Z IH K
NEAR	N IH R
OFF	AO F
ON	AA N
ON(2)	AO N
PLAY	P L EY
SEND	S EH N D
SET	S EH T
STEVEN	S T IY V AH N
THE	DH AH
THE(2)	DH IY
TURN	T ER N
WEATHER	W EH DH ER
WHERE	W EH R
WHERE(2)	HH W EH R
WHO	HH UW
